NO wood.xpm
EA wood.xpm
SO wood.xpm
WE wood.xpm

C 36, 36, 36
F 138, 138, 138

111111111111111
100000000000001
100000000000001
100000000000001
100000000000001
100000000000001
100000000000001
100000000000001
100000000000001
111111111111111
