NO ./texture/wood.xpm
SO ./texture/wood.xpm
WE ./texture/wood.xpm
EA ./texture/wood.xpm

F 138,138,138
C 56,182,255

1111111111
1000000001
1000000001
1111001111
1000000001
10000S0001
1000000001
1000000001
1000000001
1111111111
