NO ./texture/wall_red.xpm
SO ./texture/wall_red.xpm
WE ./texture/wall_red.xpm
EA ./texture/wall_red.xpm

F 220,100,0
C 220,100,0

111111111111111
111111000111111
111110000011111
1111000S0001111
111000010000111
110000111000011
100001111100001
110000111000011
111000010000111
111100000001111
111110000011111
111111000111111
111111111111111