NO textures/bluestone.xpm
SO textures/colorstone.xpm
WE textures/greystone.xpm
EA textures/redbrick.xpm
S textures/barrel.xpm
F 255,0,0
C 0,0,255

11111 111 11111 11111111111
11000001 100011 1000001 1000000000001
100000001 101000110000001 1000000000001
11 1 1 100000011 11 1 1000000000000001 1110000000000001
1001101101 11000001 10011011 1010001100000001 10000000000000001